25 25
100 100
4 10 10 10 10 10 10 10 10 10 10 10 10 10 10 10 10 10 10 10 10 10 10 10 5
8 12 12 12 12 12 1  1  1  1  1  1  1  1  1  1  1  1  1  1  1  3  2  3  9
8 1  1  1  1  12 1  1  1  1  1  1  1  1  1  1  1  1  1  1  1  3  2  3  9
8 1  1  1  1  12 1  1  1  1  1  1  1  1  1  1  1  1  1  1  1  3  2  3  9
8 1  1  1  1  12 12 12 1  1  1  1  1  1  1  1  1  1  1  1  1  3  2  3  9
8 1  1  1  1  2  2  2  1  1  1  1  1  1  1  1  1  1  1  1  1  2  2  2  9
8 1  1  1  1  12 12 12 1  1  1  1  1  1  1  1  1  1  1  1  1  1  1  1  9
8 1  1  1  1  12 1  1  1  1  1  1  1  1  1  1  1  1  1  1  1  1  1  1  9
8 12 12 12 12 12 1  1  1  1  1  1  1  1  1  1  1  1  1  1  1  1  1  1  9
8 1  1  1  1  1  1  1  1  1  1  1  1  1  1  1  1  1  1  1  1  1  1  1  9
8 1  1  1  1  1  1  1  1  12 12 2  12 12 1  1  1  1  1  1  1  1  1  1  9
8 1  1  1  1  1  1  1  1  12 1  1  1  12 1  1  1  1  1  1  1  1  1  1  9
8 1  1  1  1  1  1  1  1  2  1  1  1  2  1  1  1  1  1  1  1  1  1  1  9
8 1  1  1  1  1  1  1  1  12 1  1  1  12 1  1  1  1  1  1  1  1  1  1  9
8 1  1  1  1  1  1  1  1  12 12 2  12 12 1  1  1  1  1  1  1  1  1  1  9
8 1  1  1  1  1  1  1  1  1  1  1  1  1  1  1  1  1  1  1  1  1  1  1  9
8 1  1  1  1  1  1  1  1  1  1  1  1  1  1  1  1  1  1  1  1  1  1  1  9
8 1  1  1  1  1  1  1  1  1  1  1  1  1  1  1  1  1  1  1  1  1  1  1  9
8 1  1  1  1  1  1  1  1  1  1  1  1  1  1  1  1  1  1  1  1  1  1  1  9
8 1  1  1  1  1  1  1  1  1  1  2  2  2  1  1  1  1  1  1  1  1  1  1  9
8 12 1  1  1  1  1  1  1  1  1  2  2  2  2  2  1  1  1  1  1  1  1  12 9
8 12 12 1  1  1  1  1  1  1  1  2  2  2  1  1  1  1  1  1  1  1  12 12 9
8 12 12 12 1  1  1  1  1  1  1  1  1  1  1  1  1  1  1  1  1  12 12 12 9
8 12 12 12 12 1  1  1  1  1  1  1  1  1  1  1  1  1  1  1  12 12 12 12 9
7 11 11 11 11 11 11 11 11 11 11 11 11 11 11 11 11 11 11 11 11 11 11 11 6